WWWWWWWWWWWWWWW
W.....G.......W
W....WWW......W
W.............W
WWWW..........W
W..........WWWW
W.....WWW.....W
WWWW..........W
W..........WWWW
W....P........W
WWWWWWWWWWWWWWW