WWWWWWWWWWWWWWW
W.....G.......W
W....WWW......W
W...........WWW
W.....WWWW....W
WWWW..........W
W..........WWWW
W....P........W
WWWWWWWWWWWWWWW